esophagus	esophagus
spleen	spleen
psoas_muscle	psoas_muscle
spinal_cord	spinal_cord
skeletal_muscle_cell	skeletal_muscle_cell
smooth_muscle_cell	smooth_muscle_cell
aorta	aorta
sigmoid_colon	sigmoid_colon
cardiac_fibroblast	cardiac_fibroblast
left_ventricle	left_ventricle
brain	brain
right_ventricle	right_ventricle
common_myleoid_progenitor	common_myleoid_progenitor
kidney_epithethial	kidney_epithethial
endothermal_cell	endothermal_cell
adrenal_gland	adrenal_gland
t_cell	t_cell
stomach	stomach
tibial_nerve	tibial_nerve
neural_stem_cell	neural_stem_cell
cardiac_muscle_cell	cardiac_muscle_cell
muscle_of_leg	muscle_of_leg
aortic_smooth_muscle	aortic_smooth_muscle
kidney	kidney
uterus	uterus
cd14_positive	cd14_positive
B_cell	B_cell
natural_killer_cell	natural_killer_cell
skeletal_muscle	skeletal_muscle
adipose_tissue	adipose_tissue
mononuclear_cell	mononuclear_cell
upper_lobe_of_left_lung	upper_lobe_of_left_lung
right_cardiac_atrium	right_cardiac_atrium
large_intestine	large_intestine
small_intestine	small_intestine
body_of_pancreas	body_of_pancreas
pancreas	pancreas
thymus	thymus
lung	lung
pericardium	pericardium
muscle_of_trunk	muscle_of_trunk
bronchial_epithethial	bronchial_epithethial